0000000000000000000000000000000000000000000000000000000000000000000000000000000000000000300000000000000000000000000000000000000000000000000000000000000000000000000000000000000000000000000000000000000000000000000000000000000000000000000000000000000000000000000000000000000000000000000000000000000000000000000000000000000000000000000000000000000000000000000000000000000000000000000000000006666666666666666666666666666666666666666666666666666666666666666666666666666666660000000000000000000000000000066666666666666666666666666666666666666666666666666666666660000000000000000066666666666666666666666666
0000000000000000000000000000000000000000000000000000000000000000000000000000000000000000300000000000000000000000000000000000000000000000000000000000000000000000000000000000000000000000000000000000000000000000000000000000000000000000000000000000000000000000000000000000000000000000000000000000000000000000000000000000000000000000000000000000000000000000000000000000000000000000000000000006666666666666666666666666666666666666666666666666666666666666666666666666666666660000000000000000000000000000066666666666666666666666666666666666666666666666666666666660000000000000000066666666666666666666666666
0000000000000000000000000000000000000000000000000000000000000000000000000000000000000000300000000000000000000000000000000000000000000000000000000000000000000000000000000000000000000000000000000000000000000222222222000000000000000000000000000000000000000000000000000000000000000000000000000000000000000000000000000000000000002220002200000000000220000000000000000000000000000000000000000006666666666666666666666666666666666666666666666666666666666666666666666666666666660000000000000000000000000000066666666666666666666666666666666666666666666666666666666660000000000000000066666666666666666666666666
0000000000000000000000000000000000000000000000000000000000000000000000000000000000000000300000000000000000000000000000000000000000000000000000000000000000000000000000000000000000000000000000000000000000000111111111000000000000000000000000000000000000000000000000000000000000000000000000000000000000000000000220022222002222221110001100220002200110022222222222000000000000000000000000000006666666666666666666666666666666666666666000000000000000000000000000000000000000000000000000000000000000000000066666666666666666666666666666666666666666666666666666666660000000000000000066666666666666666666666666
3000000000000000000000000000000000000000000000000000000000000000000000000000000000000000300000000000000000000000000000000000000000000000000000000000000000000000000900000000000000000000000000000000000002200000000000000000000000000000000000000000000000000000000000000000000000000000000000000000000000000000000110011111001111111110001100110001100110011111111111000000000000000080000000000006666666666666666666666666666666666666666000000000000000000000000000000000000000000000000005555000000000000000066666666666666000000000000000000000066666666666666666666660000000000000000066666666666666666666666666
3000000000000000000000000000000000000000000000000000000000000000000000000000000000000000300000000000000000000000000000000000000000000000000000000000000000000222222222200022200002220000000000000000000000000000000002222000000000000000000000000000000000000000000000000000000000000000000000000000000000000000022110011111001111111110001100110001100110011111111111000005555555555555555500000006666600000000000000000000666666666600000000555555555555555555555500000000000000000000000006666000000000000000066666666666000000000000000000000000000000000000000000000000000000000000000066666666666666666666666666
3000000000000000000000000000000000000000000000000000000000000000000000000444444000000000300000000000000004000000000000000000000000000000000000000000000004400111111111100011100001110000000000000000000000000220000000000000000000000000000000000000000000000000000000000000000000000000000000000022000000002222211110011111001111111110001100110001100110011111111111000006666666666666666600000006666600000000000000000000666666666600000000000000000000000000000655500000000000000005555006666000000000000000066666666000000005555000000055555500000000000000000000000000000000000000000066666666666666666666666666
3000000000000000000000000000000000000000000000000000000000000000000000000000000000444440000000000400040000000400000000000000000000000000000000000000000443300111111111100011100001112220000000000000000000000000000000000020000000000000000000000000000000000000000000000000022000000000000000000011000222001111111110011111001111111110001100110001100110011111111111000006666666666666666600000006666600000000000050000000666666666655555500000000000000000000000666655555555555555556666556666555555555555550000000000000000000000000000000000000000000000000000000000000000000000000000066666666666666666666666666
3000000000000000000000000000000000000000000000000000000000000000000044400000000000300000000000004300000000000000000000000000000000000000000000000000044333300111111111100011100001110000000000000002200000000000022000000012000000000000000000000000000000000000000000000000011000022222000000220000000111001111111110011111001111111110001100110001100110011111111111000006666666666666666600500006666600055555555560000000666666666600000655555555555555000000000600600000000000000006666666666000000000000000000000000000555000000005555500000055555000000000005555555555555555555555555566666666666666666666666666
3000000000000000000000000000000000000000000000000000000000000000004433300000000000300000000000043300000000000000000000000000000000000000000000000004433333300111111111100011100001110000000000000001100000000000000000000000000000000000000000000000000000000000000000000002211000011111000000110000000000001111111110011111001111111110001100110001100110011111111111000006666666666666666600600006666650000000000000000000000000000000000000000000000000000000000600600000000077777776666666666777777700000000000000000555666000000006666600000066666005500550006666666666666666666666666666666666666666666666666666
3000000000000000000004400000004444440000004000004000000000000000443333300444440000344440004444433344444444444444440000000000400400000000000000000443333333300111111111100011100001112220000000022001100000222220000000000000000000000000000000000000000000000000000000000001111000000000002200000220000000001111111110011111001111111110001100110001100110011111111111000006666666666666666600600000000000000000000000055000000000000000500000000000000000005555555655600000000066666666666666666666666600000000055555555666666000000006666600000066666006000060006666666666666666666666666666666666666666666666666666
3000000000000000000A00000000000000000000003000003000000000000044333333300000000000333330003333333333333333333333334440000004300340000000000000044333333333300111111111100011100001111110000000011001100000111112220000000000222222000220000000022000000002200000000000002201111000000000001100000110000000001111111110011111001111111110001100110001100110011111111111000006666666666666666600650000000000055550000000066000000500000000600000000050000000000000000600600000000066666666666666666666666600000000066666666666666000000006666600000066666006000060006666666666666666666666666666666666666666666666666666
3444444444444440044440044444000000000044400044400044400044444433333333300000000000000000003333333333333333333333333334444443300334444000004444433333333333300111111111100011100001111110002220011001100000000000000222200222111111000000002200000000220000000220000220001101111000000000000000000000000000001111111110011111001111111110001100110001100110011111111111000006666666666666666600600005500550066660055005566000555655555550605555500065555555555555555600600000000066666666666666666666666600000000066666666666666000000006666600000066666006000060006666666666666666666666666666666666666666666666666666
3333333333333330033330033333000000000033300033300033300033333333333333300000000000000000003333333333333333333333333333333333300333333004003333333333333333300111111111100011100001111110001110011001100000000000000000000000111100000000001100000000110000000110000110001101111000000000000000000000000000001111111110011111001111111110001100110001100110011111111111000006666666666666666600600006000060066660066000066000000000000000600000000060000000000000000600600000000066666666666666666666666600000000066666666666666000000006666600000066666006000060006666666666666666666666666666666666666666666666666666
3333333333333337733330033333000000000000000000000000000033333333333333300000000000000000003333333333333333333333333333333333377333333777773333333333333333377111111111177711177771111117771110011771177777777777777777777777111100000000001100000000110000000117777110001101111000000000000000000000000000001111111110011111001111111110001100110001100110011111111111000006666666666666666600677776777767766667766777766777777777777777677777777767777777777777777677677777777766666666666666666666666677777777766666666666666777777776666677777766666776777767776666666666666666666666666666666666666666666666666666
3333333333333333333330033333000000000000000000000000000033333333333333300000000000000000000000000000000000000000333333333333333333333333333333333333333333333111111111111111111111111111111110011111111111111111111111111111111100000000001100000000110000000111111110001101111000000000000000000000000000001111111110011111001111111110001100110001100110011111111111000006666666666666666600666666666666666666666666666666666666666666666666666666666666666666666666666666666666666666666666666666666666666666666666666666666666666666666666666666666666666666666666666666666666666666666666666666666666666666666666
3333333333333333333330033333000000000000000000000000000000000000000000000000000000000000000000000000000000000000333333333333333333333000003333300000000000000000000000000000000000000000000000000000000000000000000000000000000000000000000000000000000000000000000000000000000000000000000000000000000000001111111110011111001111111110001100110001100110011111111111000006666666666666666600666666666666666666666666666666666666666666666666666666666666666666666666666666666666666666666666666666666666666666666666666666666666666666666666666666666666666666666666666666666666666666666666666666666666666666666666
3333333333333333333330033333000000000000000000000000000000000000000000000000000000000000000000000000000000000000333333333333333333333000003333300000000000000000000000000000000000000000000000000000000000000000000000000000000000000000000000000000000000000000000000000000000000000000000000000000000000001111111110011111001111111110001100110001100110011111111111000006666666666666666600666666666666666666666666666666666666666666666666666666666666666666666666666666666666666666666666666666666666666666666666666666666666666666666666666666666666666666666666666666666666666666666666666666666666666666666666

